50
29
4 4 4 4 4 4 4 4 4 4 4 4 4 4 4 4 4 4 4 4 4 4 4 4 4 4 4 4 4 4 4 4 4 4 4 4 4 4 4 4 4 4 4 4 4 4 4 4 4 100
4 1 1 1 1 1 1 1 1 1 1 1 1 1 1 1 1 1 1 1 1 1 1 1 1 1 1 1 1 1 1 1 1 1 1 1 1 1 1 1 1 1 1 1 1 1 1 1 100 100
4 1 100 100 100 100 100 100 0 0 0 0 0 0 0 100 100 100 100 100 100 100 100 100 100 100 100 100 100 100 100 100 100 100 100 100 100 100 100 100 100 100 100 100 100 100 100 100 100 100
4 1 100 0 0 0 0 0 0 0 0 0 0 0 0 0 0 0 0 0 0 0 0 0 0 0 0 0 0 0 0 0 0 0 0 0 0 0 0 0 0 0 0 0 0 0 0 0 0 100
4 1 100 0 99 99 99 99 99 99 99 99 99 99 99 99 99 99 99 99 99 99 99 99 99 99 99 99 99 99 99 99 99 99 99 99 99 99 99 99 99 99 99 99 99 99 99 99 99 99
4 1 100 0 99 100 0 4 4 4 100 4 4 4 4 4 4 4 4 4 4 4 4 4 4 4 4 4 4 4 4 4 4 4 4 4 4 4 4 4 4 4 4 4 4 4 4 4 4 99
4 1 100 0 99 100 0 0 0 0 0 0 0 0 0 0 0 0 0 0 0 0 0 0 0 0 0 0 0 0 0 0 0 0 0 0 30 0 0 0 0 0 0 0 0 0 0 0 0 99
4 1 100 0 99 100 0 0 100 100 100 100 100 100 100 100 100 100 100 100 100 100 100 100 100 32 100 100 0 0 0 0 0 0 0 0 0 100 100 100 100 32 100 100 100 100 100 100 100 99
4 4 1 0 99 99 100 0 0 0 0 0 0 0 0 0 32 0 0 0 0 0 0 0 0 0 0 0 0 0 0 0 0 0 0 0 0 0 0 0 0 0 0 0 0 0 0 0 100 99
4 4 1 0 0 99 100 0 0 0 0 100 0 0 100 0 0 100 0 100 0 0 100 0 0 20 0 0 0 0 0 0 0 0 0 0 0 0 0 0 0 0 100 100 7 100 100 0 100 99
4 4 1 1 0 99 99 100 0 100 0 0 0 0 0 0 0 0 0 0 0 0 10 0 0 0 0 0 0 0 0 0 0 0 100 100 100 100 100 100 100 0 0 0 0 0 0 0 100 99
4 4 100 1 0 0 99 100 0 0 100 100 100 100 100 100 100 0 0 100 100 100 100 100 100 100 6 100 100 100 100 0 0 0 0 0 0 0 11 0 0 0 0 100 100 100 100 0 100 99
4 4 100 1 100 0 99 100 0 0 0 0 0 0 0 0 0 0 0 0 0 0 0 0 11 0 0 0 3 0 0 0 0 0 0 0 0 0 100 100 100 100 100 0 0 100 100 0 100 99
4 4 100 1 100 0 99 100 0 0 0 100 100 0 100 0 0 0 0 100 0 0 0 0 100 0 0 0 0 0 0 0 0 0 0 0 0 0 0 0 100 100 0 0 100 0 0 0 100 99
4 4 0 1 100 0 99 100 0 100 0 0 0 100 20 100 100 20 100 6 0 0 0 0 0 0 0 0 0 0 0 0 100 0 0 0 0 0 0 0 100 0 100 100 0 0 0 0 100 99
4 0 30 1 100 0 99 100 0 0 100 0 0 0 0 0 100 0 100 0 0 3 0 0 0 100 0 0 0 100 0 0 0 0 0 0 0 0 0 0 0 100 100 100 0 0 0 0 100 99
4 34 0 1 100 0 99 100 0 0 100 100 100 0 0 0 0 0 0 0 0 100 0 0 0 0 0 100 0 0 0 0 0 100 0 20 0 0 0 0 0 100 100 0 0 0 100 0 100 99
4 4 100 4 1 0 99 99 100 0 100 0 0 100 0 0 0 0 0 0 0 0 0 0 0 100 10 0 0 0 0 100 11 0 0 0 0 0 100 0 0 13 0 0 100 0 0 0 100 99
4 34 4 4 1 0 0 99 100 0 100 0 0 0 0 20 0 0 0 11 0 0 0 0 0 10 10 10 0 100 100 14 0 0 0 0 0 100 100 0 0 100 0 0 100 0 100 0 100 99
4 4 4 4 1 100 0 99 100 0 0 0 0 100 100 0 0 0 0 100 100 0 0 0 0 0 10 10 0 0 0 0 0 0 0 0 100 0 0 0 0 100 0 0 100 0 100 0 100 99
4 4 4 4 1 100 0 99 100 0 0 100 0 100 0 0 0 0 0 0 0 0 0 0 0 0 0 0 10 10 0 0 0 0 0 0 0 100 0 0 100 100 0 0 0 0 0 0 100 99
4 4 7 4 1 100 0 99 100 0 0 100 0 100 100 0 0 0 100 100 0 0 100 0 0 0 0 0 0 0 0 0 0 0 0 0 0 0 0 0 0 0 0 0 0 0 0 0 100 99
4 4 4 4 1 1 0 99 99 100 0 0 0 100 100 0 7 0 100 100 0 0 0 0 7 0 6 0 0 0 0 14 0 20 0 0 0 0 100 13 100 100 100 100 100 0 0 0 100 99
4 13 4 30 100 1 0 0 99 100 0 0 0 100 0 0 100 0 0 0 0 0 100 100 100 100 100 100 3 100 0 0 0 0 0 0 0 0 0 0 0 0 0 0 0 0 0 0 100 99
4 0 4 100 4 1 100 0 99 100 0 100 100 0 0 0 0 0 0 0 0 0 0 0 0 0 0 0 0 0 0 0 0 100 0 0 0 0 0 0 0 0 0 0 0 0 0 0 100 99
4 100 0 100 4 1 100 0 99 100 0 100 100 100 100 100 100 100 100 100 100 100 100 100 100 100 100 100 100 100 100 100 100 100 100 100 100 100 100 100 100 100 100 100 100 100 100 0 100 99
4 30 4 4 4 100 100 0 99 100 0 0 0 0 0 0 0 0 0 0 0 0 0 0 0 0 0 0 0 0 0 0 0 0 0 0 0 0 0 0 0 0 0 0 0 0 0 0 100 99
4 4 4 4 4 100 100 100 99 99 99 99 99 99 99 99 99 99 99 99 99 99 99 99 99 99 99 99 99 99 99 99 99 99 99 99 99 99 99 99 99 99 99 99 99 99 99 99 99 99
100 100 100 100 100 100 100 100 100 100 100 100 100 100 100 100 100 100 100 100 100 100 100 100 100 100 100 100 100 100 100 100 100 100 100 100 100 100 100 100 100 100 100 100 100 100 100 100 100 100
