50
29
1 0 100 1 100 100 1 100 100 1 100 100 1 100 1 100 100 1 100 100 1 100 1 1 100 100 1 100 100 1 100 100 1 100 100 1 100 100 1 100 100 1 100 100 1 1 100 100 1 0
1 0 0 99 1 1 0 0 1 0 0 0 0 1 0 0 0 0 1 0 0 0 0 0 1 0 0 0 0 0 0 0 0 0 0 0 0 0 0 0 0 0 0 1 0 0 0 0 1 0
1 0 100 99 0 0 0 0 0 0 0 0 0 0 0 0 0 0 0 0 0 0 0 0 1 0 0 0 0 0 1 1 0 0 0 0 0 1 0 0 0 0 0 0 0 0 0 0 0 0
1 0 100 99 0 0 0 0 0 0 0 0 0 0 0 99 99 99 99 99 99 99 99 99 99 0 0 99 99 99 99 0 0 0 99 99 99 99 0 0 99 99 99 99 0 0 99 99 99 99
1 0 100 99 99 99 99 99 99 99 99 99 99 99 99 0 0 0 0 0 0 0 0 0 99 0 0 99 0 0 99 0 0 0 99 0 0 99 0 0 99 0 0 99 99 99 99 0 0 0
1 0 100 99 4 0 0 0 0 0 0 0 0 0 0 0 0 0 0 0 0 0 0 0 99 99 99 0 0 0 99 99 99 99 0 0 0 99 99 99 99 0 0 0 0 0 0 0 0 0
1 0 100 99 4 100 0 0 0 6 0 0 0 0 0 0 0 100 100 100 100 100 100 100 100 100 100 100 100 0 0 0 100 100 100 100 100 100 0 0 0 0 100 0 100 100 100 100 100 100
1 0 0 99 0 0 0 30 0 0 0 3 100 0 100 100 0 0 0 100 0 100 100 0 0 0 0 0 0 6 0 0 0 0 100 0 100 0 0 0 0 0 100 0 0 100 100 100 100 100
1 0 100 99 100 0 100 100 100 0 0 100 100 30 100 0 0 32 0 0 0 0 0 0 0 0 0 0 0 0 0 3 100 100 100 100 0 0 0 0 100 100 100 100 0 100 100 100 100 100
100 1 0 99 99 0 100 100 0 0 0 0 0 0 0 0 0 0 20 100 6 0 0 100 0 6 100 0 0 100 100 0 0 0 0 0 0 11 0 9 100 100 0 100 0 100 100 100 100 100
100 1 0 0 99 100 0 0 0 30 0 0 0 100 0 0 0 0 0 0 0 100 3 0 0 0 100 3 0 0 0 0 0 0 9 0 100 0 100 0 0 0 0 100 0 100 100 100 100 100
2 1 100 0 99 0 0 0 0 0 0 100 6 0 0 100 100 0 30 0 0 100 0 0 0 32 0 0 0 0 100 0 100 0 0 0 0 0 0 100 100 100 0 100 0 100 100 100 100 100
100 1 100 0 99 100 30 0 100 30 100 0 100 100 3 0 0 0 20 100 100 100 100 100 20 0 0 0 20 0 34 0 20 0 40 0 0 100 0 100 100 0 100 0 0 100 100 100 100 100
2 1 100 0 99 0 0 0 0 100 0 0 100 0 0 0 22 0 0 0 100 20 0 0 0 0 0 0 0 100 100 0 100 100 100 0 100 0 0 100 0 100 100 0 100 100 100 100 100 100
2 1 100 100 99 0 100 0 0 0 0 0 0 0 0 0 0 0 0 100 22 0 0 6 0 0 0 100 100 32 100 0 0 2 0 2 2 0 100 0 100 0 0 0 100 100 100 100 100 100
2 1 100 100 99 0 0 0 0 6 0 0 0 0 0 100 22 100 100 0 0 0 0 0 100 3 100 0 0 0 0 34 0 7 7 7 7 0 100 0 0 0 100 100 100 100 100 100 100 100
2 1 0 0 99 100 4 100 100 0 100 3 100 0 0 100 0 0 22 100 0 100 0 32 0 0 0 40 9 0 0 100 7 7 7 7 7 0 0 0 0 100 100 0 100 100 100 100 100 100
2 1 0 100 99 100 4 0 0 100 100 100 20 6 100 100 100 100 100 100 100 0 38 6 0 38 0 0 34 0 100 100 0 0 0 0 0 0 0 100 100 100 0 100 100 100 100 100 100 100
2 100 100 100 99 0 4 0 0 4 0 20 0 20 0 3 0 100 0 0 0 0 0 36 0 3 36 0 0 100 7 0 0 100 0 0 0 0 100 9 100 0 100 100 100 100 100 100 100 100
2 1 100 100 99 0 0 100 100 100 100 100 100 100 100 0 0 0 6 0 0 0 0 0 0 0 0 0 100 100 0 100 0 0 0 0 100 100 100 0 0 100 100 100 100 100 100 100 100 100
2 1 100 100 99 0 0 100 0 100 0 100 100 0 20 0 0 0 0 0 3 0 0 100 0 0 0 0 0 100 0 0 100 13 0 100 100 9 0 100 100 100 100 100 100 100 100 100 100 100
2 100 1 100 99 99 100 100 100 100 22 100 0 0 0 0 100 0 0 100 0 0 100 0 5 5 5 5 0 100 100 0 0 100 100 100 0 0 100 100 100 100 100 100 100 100 100 100 100 100
2 100 1 100 99 99 100 100 100 100 100 100 0 100 100 100 100 100 100 100 100 100 100 100 100 0 0 0 100 13 13 13 100 100 100 0 100 100 100 100 100 100 100 100 100 100 100 100 100 100
2 100 1 100 99 99 100 100 100 100 100 100 100 100 100 100 100 100 100 100 100 100 100 100 100 100 100 100 0 0 0 100 0 0 0 100 100 100 100 100 100 100 100 100 100 100 100 100 100 100
2 2 1 100 99 99 100 100 100 100 100 100 100 100 100 100 100 100 100 100 100 100 100 100 100 100 0 0 100 100 0 0 0 100 100 100 100 100 100 100 100 100 100 100 100 100 100 100 100 100
100 100 1 100 99 99 100 100 100 100 100 100 100 100 100 100 100 100 100 100 100 100 100 100 100 100 0 0 0 0 0 100 100 100 100 100 100 100 100 100 100 100 100 100 100 100 100 100 100 100
100 100 1 100 99 99 100 100 100 100 100 100 100 100 100 100 100 100 100 100 100 100 100 100 100 100 0 100 100 100 100 100 100 100 100 100 100 100 100 100 100 100 100 100 100 100 100 100 100 100
100 100 100 100 99 99 100 100 100 100 100 100 100 100 100 100 100 100 100 100 100 100 100 100 100 100 100 100 100 100 100 100 100 100 100 100 100 100 100 100 100 100 100 100 100 100 100 100 100 100
100 100 100 100 100 100 100 100 100 100 100 100 100 100 100 100 100 100 100 100 100 100 100 100 100 100 100 100 100 100 100 100 100 100 100 100 100 100 100 100 100 100 100 100 100 100 100 100 100 100